===================================================================
ğŸ¤– COMMANDS FOR BOTFATHER
===================================================================
Copy and paste these commands into BotFather when configuring your bot:
(Main Menu â†’ /mybots â†’ Choose your bot â†’ Edit Bot â†’ Edit Commands)

status - ğŸ“Š Quick system overview
quick - âš¡ Ultra-compact one-liner status
docker - ğŸ³ Manage Docker containers
dstats - ğŸ“ˆ Container resource usage
top - ğŸ” Top processes by CPU/RAM
temp - ğŸŒ¡ Check system temperatures
net - ğŸŒ Network information
logs - ğŸ“ View recent system logs
logsearch - ğŸ” Search container logs
report - ğŸ“‹ Generate full system report
ping - ğŸ“ Check bot availability
health - ğŸ’“ Healthchecks.io status & stats
config - âš™ï¸ Show current configuration
sysinfo - ğŸ’» Detailed system information
speedtest - ğŸš€ Run internet speed test
diskpred - ğŸ’¾ Disk space prediction
settings - ğŸ”§ Configure bot settings
language - ğŸŒ Change language (EN/IT)
container - ğŸ“¦ Manage specific container
kill - ğŸ’€ Force kill a container
restartdocker - ğŸ”„ Restart Docker service
reboot - ğŸ” Reboot the system
shutdown - â¹ Shutdown the system
help - â“ Show all available commands
===================================================================
